T11111111111111111111111111111T
1111111111111111111111111111111
1111111111C000000000000000000E1
11111111111111111111111111C1111
1C00000000000000000000000001111
111111111110C111111111111111111
1111111111101111111111111111111
1P00000000000111111111111111111
T11111111111111111111111111111T