111111111111111111111111111111111111111111111
1P1000100010001000100010000000000000000000001
101010101010101010101010101010101010101010101
101010101010101010101010101010101010101010101
101010101010101010101010101010101010101010101
101010101010101010101010101010101010101010101
101010101010101010101010101010101010101010101
101010101010101010101010101010101010101010101
101010101010101010101010101010101010101010101
101010101010101010101010101010101010101010101
101010101010101010101010101010101010101010101
101010101010101010101010101010101010101010101
101010101010101010101010101010101010101010101
101010101010101010101010101010101010101010101
101010101010101010101010101010101010101010101
101010101010101010101010101010101010101010101
101010101010101010101010101010101010101010101
101010101010101010101010101010101010101010101
101010101010101010101010101010101010101010101
101010101010101010101010101010101010101010101
101010101010101010101010101010101010101010101
101010101010101010101010101010101010101010101
1CCC0CCC0CCC0CCC0CCC0CEC0CCC0CCC0CCC0CCC0CCC1
111111111111111111111111111111111111111111111