1111111
100C001
1000001
100C001
100E001
100P001
1000001
1000001
1000001
1110111
100C001
1111111