T1111111111111111111111111111111111111111T
100000011111000000010000000100000000000001
101111010000001111110000000100000000000001
100000010111111000010000000100100000000001
100011110000000001010000000100100000000001
10E000010111111101000100010010000000000111
10C000010000000001010001000100100000000001
10P000000000000001000001000000100000000001
100000000000000001000001000000100000000001
100000000000000001000001000000000000000001
100000000000000000000001000000000000000001
100000000000000000000000000000000000000001
1000000000000000000000000000000000000000B1
1000C0000000000000000000000000000000000001
T1111111111111111111111111111111111111111T